1111111111111
1P1CC0100CCC1
10110C101E1C1
1C0C000C1CCC1
1111111111111
