11111111111111
11111101111111
1111P1EC111111
11111101111111
11111111111111