11111111111111111111111111111111111111111111111111111111111111111111111111111111111111111111111111111111
1C0E0000000000000000000000000000000000000000000000000000000000000000000000000000000000000000000000000001
1C100000000000000000000000000000000000000000000000000000000000000000000000000000000000000000000000000001
1C100000000000000000000000000000000000000000000000000000000000000000000000000000000000000000000000000001
10100000000000000000000000000000000000000000000000000000000000000000000000000000000000000000000P00000001
1C100000000000000000000000000000000000000000000000000000000000000000000000000000000000000000000000000001
10100000000000000000000000000000000000000000000000000000000000000000000000000000000000000000000000000001
10100000000000000000000000000000000000000000000000000000000000000000000000000000000000000000000000000001
10100000000000000000000000000000000000000000000000000000000000000000000000000000000000000000000000000001
10000000000000000000000000000000000000000000000000000000000000000000000000000000000000000000000000000001
10100000000000000000000000000000000000000000000000000000000000000000000000000000000000000000000000000001
10100000000000000000000000000000000000000000000000000000000000000000000000000000000000000000000000000001
10000000000000000000000000000000000000000000000000000000000000000000000000000000000000000000000000000001
10100000000000000000000000000000000000000000000000000000000000000000000000000000000000000000000000000001
10100000000000000000000000000000000000000000000000000000000000000000000000000000000000000000000000000001
10000000000000000000000000000000000000000000000000000000000000000000000000000000000000000000000000000001
10100000000000000000000000000000000000000000000000000000000000000000000000000000000000000000000000000001
10000000000000000000000000000000000000000000000000000000000000000000000000000000000000000000000000000001
10100000000000000000000000000000000000000000000000000000000000000000000000000000000000000000000000000001
10100000000000000000000000000000000000000000000000000000000000000000000000000000000000000000000000000001
10000000000000000000000000000000000000000000000000000000000000000000000000000000000000000000000000000001
10100000000000000000000000000000000000000000000000000000000000000000000000000000000000000000000000000001
10100000000000000000000000000000000000000000000000000000000000000000000000000000000000000000000000000001
10000000000000000000000000000000000000000000000000000000000000000000000000000000000000000000000000000001
10100000000000000000000000000000000000000000000000000000000000000000000000000000000000000000000000000001
10000000000000000000000000000000000000000000000000000000000000000000000000000000000000000000000000000001
10100000000000000000000000000000000000000000000000000000000000000000000000000000000000000000000000000001
10100000000000000000000000000000000000000000000000000000000000000000000000000000000000000000000000000001
10000000000000000000000000000000000000000000000000000000000000000000000000000000000000000000000000000001
10100000000000000000000000000000000000000000000000000000000000000000000000000000000000000000000000000001
10100000000000000000000000000000000000000000000000000000000000000000000000000000000000000000000000000001
10000000000000000000000000000000000000000000000000000000000000000000000000000000000000000000000000000001
10100000000000000000000000000000000000000000000000000000000000000000000000000000000000000000000000000001
10000000000000000000000000000000000000000000000000000000000000000000000000000000000000000000000000000001
10100000000000000000000000000000000000000000000000000000000000000000000000000000000000000000000000000001
10100000000000000000000000000000000000000000000000000000000000000000000000000000000000000000000000000001
10000000000000000000000000000000000000000000000000000000000000000000000000000000000000000000000000000001
10100000000000000000000000000000000000000000000000000000000000000000000000000000000000000000000000000001
10100000000000000000000000000000000000000000000000000000000000000000000000000000000000000000000000000001
10000000000000000000000000000000000000000000000000000000000000000000000000000000000000000000000000000001
11111111111111111111111111111111111111111111111111111111111111111111111111111111111111111111111111111111