111111111
1P0001E11
10000C001
1C1001001
111111111